++++++++++++++++++++++++++++++++++++++++++++++++++++++++
+||||||||||||||||||||||||||++||||||||||||||||||||||||||+
+||||||||||||||||||||||||||++||||||||||||||||||||||||||+
+||||||||||||||||||||||||||++||||||||||||||||||||||||||+
+||||||||||||||||||||||||||++||||||||||||||||||||||||||+
+||||++++++||||++++++++||||++||||++++++++||||++++++||||+
+||||+||||+||||+||||||+||||++||||+||||||+||||+||||+||||+
+||||+||||+||||+||||||+||||++||||+||||||+||||+||||+||||+
+||||++++++||||++++++++||||++||||++++++++||||++++++||||+
+||||||||||||||||||||||||||||||||||||||||||||||||||||||+
+||||||||||||||||||||||||||||||||||||||||||||||||||||||+
+||||||||||||||||||||||||||||||||||||||||||||||||||||||+
+||||||||||||||||||||||||||||||||||||||||||||||||||||||+
+||||++++++||||++||||++++++++++++++||||++||||++++++||||+
+||||++++++||||++||||++++++++++++++||||++||||++++++||||+
+||||||||||||||++||||||||||++||||||||||++||||||||||||||+
+||||||||||||||++||||||||||++||||||||||++||||||||||||||+
+||||||||||||||++||||||||||++||||||||||++||||||||||||||+
+||||||||||||||++||||||||||++||||||||||++||||||||||||||+
+++++++++++||||++++++++||||++||||++++++++||||+++++++++++
||||||||||+||||++++++++||||++||||++++++++||||+||||||||||
||||||||||+||||++||||||||||||||||||||||++||||+||||||||||
||||||||||+||||++||||||||||||||||||||||++||||+||||||||||
||||||||||+||||++||||||||||||||||||||||++||||+||||||||||
||||||||||+||||++||||||||||||||||||||||++||||+||||||||||
||||||||||+||||++||||++++++++++++++||||++||||+||||||||||
+++++++++++||||++||||+||||||||||||+||||++||||+++++++++++
-||||||||||||||||||||+||||||||||||+||||||||||||||||||||-
-||||||||||||||||||||+||||||||||||+||||||||||||||||||||-
-||||||||||||||||||||+||||||||||||+||||||||||||||||||||-
-||||||||||||||||||||+||||||||||||+||||||||||||||||||||-
+++++++++++||||++||||+||||||||||||+||||++||||+++++++++++
||||||||||+||||++||||++++++++++++++||||++||||+||||||||||
||||||||||+||||++||||||||||||||||||||||++||||+||||||||||
||||||||||+||||++||||||||||||||||||||||++||||+||||||||||
||||||||||+||||++||||||||||||||||||||||++||||+||||||||||
||||||||||+||||++||||||||||||||||||||||++||||+||||||||||
||||||||||+||||++||||++++++++++++++||||++||||+||||||||||
+++++++++++||||++||||++++++++++++++||||++||||+++++++++++
+||||||||||||||||||||||||||++||||||||||||||||||||||||||+
+||||||||||||||||||||||||||++||||||||||||||||||||||||||+
+||||||||||||||||||||||||||++||||||||||||||||||||||||||+
+||||||||||||||||||||||||||++||||||||||||||||||||||||||+
+||||++++++||||++++++++||||++||||++++++++||||++++++||||+
+||||++++++||||++++++++||||++||||++++++++||||++++++||||+
+||||||||++||||||||||||||||||||||||||||||||||++||||||||+
+||||||||++||||||||||||||||||||||||||||||||||++||||||||+
+||||||||++||||||||||||||||||||||||||||||||||++||||||||+
+||||||||++||||||||||||||||||||||||||||||||||++||||||||+
+++++||||++||||++||||++++++++++++++||||++||||++||||+++++
+++++||||++||||++||||++++++++++++++||||++||||++||||+++++
+||||||||||||||++||||||||||++||||||||||++||||||||||||||+
+||||||||||||||++||||||||||++||||||||||++||||||||||||||+
+||||||||||||||++||||||||||++||||||||||++||||||||||||||+
+||||||||||||||++||||||||||++||||||||||++||||||||||||||+
+||||++++++++++++++++++||||++||||++++++++++++++++++||||+
+||||++++++++++++++++++||||++||||++++++++++++++++++||||+
+||||||||||||||||||||||||||||||||||||||||||||||||||||||+
+||||||||||||||||||||||||||||||||||||||||||||||||||||||+
+||||||||||||||||||||||||||||||||||||||||||||||||||||||+
+||||||||||||||||||||||||||||||||||||||||||||||||||||||+
++++++++++++++++++++++++++++++++++++++++++++++++++++++++